          ~$HIR$通告:圣修塔因城市政设施改造中!$NOR$~

$YEL$####################################################$NOR$
# ################################################ #
# #                      王                      # #
# #                      宫                      # #
# #######################--####################### #
# #            $HIG$旅 店$NOR$            $HIY$教 堂$NOR$            # #
# #           -75,26           -69,26            # #
# #                                              # #
# #           杂货铺  $HIC$-72,24$NOR$ 防具铺  武器铺      # #
# #                                              # #
# #                                              # #
# #######################$BCYN$城$NOR$####################### #
#########################$BCYN$门$NOR$#########################
                      $RED$-72,20$NOR$
